#####
#@ $#
#   #
#  .#
#####

