######
#@   #
# $.$#
#   .#
######
