#########
#@      #
#  .$.  #
#  $ $  #
#  .$.  #
#       #
#########
