######
#@   #
#  .$#
#   .#
######
